Code	Organism
tajulius_eg_gene	Triticum aestivum Julius genes (PGSBv2.0_Julius)
sitalica_eg_gene	Setaria italica genes (Setaria_italica_v2.0)
tccriollo_eg_gene	Theobroma cacao Belizian Criollo B97-61/B2 genes (Criollo_cocoa_genome_V2)
clanatus_eg_gene	Citrullus lanatus genes (Cla97_v1)
lsativa_eg_gene	Lactuca sativa genes (Lsat_Salinas_v7)
brro18_eg_gene	Brassica rapa R-o-18 genes (SCU_BraROA_2.3)
cmelo_eg_gene	Cucumis melo genes (Melonv4)
oindica_eg_gene	Oryza sativa Indica Group genes (ASM465v1)
mpolymorpha_eg_gene	Marchantia polymorpha genes (Marchanta_polymorpha_v1)
tdicoccoides_eg_gene	Triticum dicoccoides genes (WEWSeq v.1.0)
ccanephora_eg_gene	Coffea canephora genes (AUK_PRJEB4211_v1)
stuberosum_eg_gene	Solanum tuberosum genes (SolTub_3.0)
oeuropaea_eg_gene	Olea europaea genes (OLEA9)
hannuus_eg_gene	Helianthus annuus genes (HanXRQr2.0-SUNRISE)
tturgidum_eg_gene	Triticum turgidum genes (svevo)
pvulgaris_eg_gene	Phaseolus vulgaris genes (PhaVulg1_0)
bvulgaris_eg_gene	Beta vulgaris genes (RefBeet-1.2.2)
creinhardtii_eg_gene	Chlamydomonas reinhardtii genes (Chlamydomonas_reinhardtii_v5.5)
esalsugineum_eg_gene	Eutrema salsugineum genes (Eutsalg1_0)
mtruncatula_eg_gene	Medicago truncatula genes (MedtrA17_4.0)
ppatens_eg_gene	Physcomitrium patens genes (Phypa V3)
vvinifera_eg_gene	Vitis vinifera genes (PN40024.v4)
slycopersicum_eg_gene	Solanum lycopersicum genes (SL3.0)
pvera_eg_gene	Pistacia vera genes (PisVer_v2)
mesculenta_eg_gene	Manihot esculenta genes (Manihot esculenta v6)
ptrichocarpa_eg_gene	Populus trichocarpa genes (Pop_tri_v3)
fcarica_eg_gene	Ficus carica genes (UNIPI_FiCari_1.0)
graimondii_eg_gene	Gossypium raimondii genes (Graimondii2_0_v6)
phallii_eg_gene	Panicum hallii HAL2 genes (PhalliiHAL_v2.1)
onivara_eg_gene	Oryza nivara genes (Oryza_nivara_v1.0)
qlobata_eg_gene	Quercus lobata genes (ValleyOak3.0)
ccardunculus_eg_gene	Cynara cardunculus genes (CcrdV1)
nattenuata_eg_gene	Nicotiana attenuata genes (NIATTr2)
tamace_eg_gene	Triticum aestivum Mace genes (PGSBv2.0_Mace)
psomniferum_eg_gene	Papaver somniferum genes (ASM357369v1)
scereale_eg_gene	Secale cereale genes (Rye_Lo7_2018_v1p1p1)
bdistachyon_eg_gene	Brachypodium distachyon genes (Brachypodium_distachyon_v3.0)
smoellendorffii_eg_gene	Selaginella moellendorffii genes (v1.0)
sindicum_eg_gene	Sesamum indicum genes (S_indicum_v1.0)
opunctata_eg_gene	Oryza punctata genes (Oryza_punctata_v1.2)
rchinensis_eg_gene	Rosa chinensis genes (RchiOBHm-V2)
turartu_eg_gene	Triticum urartu genes (Tu2.0)
csfemale_eg_gene	Cannabis sativa female genes (cs10)
cbraunii_eg_gene	Chara braunii genes (Cbr_1.0)
sviridis_eg_gene	Setaria viridis genes (Setaria_viridis_v2.0)
hvgoldenpromise_eg_gene	Hordeum vulgare GoldenPromise genes (GPv1)
gmax_eg_gene	Glycine max genes (Glycine_max_v2.1)
hvulgare_eg_gene	Hordeum vulgare genes (MorexV3_pseudomolecules_assembly)
ccitriodora_eg_gene	Corymbia citriodora genes (Ccitriodora_v2_1)
tarobigus_eg_gene	Triticum aestivum Robigus genes (TGAC_robigus)
itriloba_eg_gene	Ipomoea triloba genes (ASM357664v1)
taarinalrfor_eg_gene	Triticum aestivum Arinalrfor genes (PGSBv2.0_Arinalrfor)
hvtritex_eg_gene	Hordeum vulgare TRITEX genes (Morex_V2_scaf)
tanorin61_eg_gene	Triticum aestivum Norin61 genes (PGSBv2.0_Norin61)
tamattis_eg_gene	Triticum aestivum Sy Mattis genes (PGSBv2.0_Mattis)
achinensis_eg_gene	Actinidia chinensis genes (Red5_PS1_1.69.0)
oesylvestris_eg_gene	Olea europaea var. sylvestris genes (O_europaea_v1)
egrandis_eg_gene	Eucalyptus grandis genes (Egrandis1_0)
tacadenza_eg_gene	Triticum aestivum Cadenza genes (TGAC_cadenza)
aofficinalis_eg_gene	Asparagus officinalis genes (Aspof.V1)
taestivum_eg_gene	Triticum aestivum genes (IWGSC)
csativa_eg_gene	Camelina sativa genes (Cs)
langustifolius_eg_gene	Lupinus angustifolius genes (LupAngTanjil_v1.0)
pavium_eg_gene	Prunus avium genes (PAV_r1.0)
ahalleri_eg_gene	Arabidopsis halleri genes (Ahal2.2)
phfil2_eg_gene	Panicum hallii FIL2 genes (PHallii_v3.1)
ncolorata_eg_gene	Nymphaea colorata genes (ASM883128v1)
psativum_eg_gene	Pisum sativum genes (Pisum_sativum_v1a)
tcacao_eg_gene	Theobroma cacao Matina 1-6 genes (Theobroma_cacao_20110822)
aalpina_eg_gene	Arabis alpina genes (A_alpina_V4)
oglumipatula_eg_gene	Oryza glumipatula genes (Oryza_glumaepatula_v1.5)
oglaberrima_eg_gene	Oryza glaberrima genes (Oryza_glaberrima_V1)
cmerolae_eg_gene	Cyanidioschyzon merolae genes (ASM9120v1)
taclaire_eg_gene	Triticum aestivum Claire genes (TGAC_paragon)
ccrispus_eg_gene	Chondrus crispus genes (ASM35022v2)
tpratense_eg_gene	Trifolium pratense genes (Trpr)
cclementina_eg_gene	Citrus clementina genes (Citrus_clementina_v1.0)
jregia_eg_gene	Juglans regia genes (Walnut_2.0)
talandmark_eg_gene	Triticum aestivum Landmark genes (PGSBv2.0_Landmark)
sspontaneum_eg_gene	Saccharum spontaneum genes (Sspon.HiC_chr_asm)
ppersica_eg_gene	Prunus persica genes (Prunus_persica_NCBIv2)
drotundata_eg_gene	Dioscorea rotundata genes (TDr96_F1_v2_PseudoChromosome)
zmays_eg_gene	Zea mays genes (Zm-B73-REFERENCE-NAM-5.0)
cquinoa_eg_gene	Chenopodium quinoa genes (ASM168347v1)
sbicolor_eg_gene	Sorghum bicolor genes (Sorghum_bicolor_NCBIv3)
tspelta_eg_gene	Triticum spelta genes (PGSBv2.0_Spelta)
ecurvula_eg_gene	Eragrostis curvula genes (CERZOS_E.curvula1.0)
cannuum_eg_gene	Capsicum annuum genes (ASM51225v2)
etef_eg_gene	Eragrostis tef genes (ASM97063v1)
kfedtschenkoi_eg_gene	Kalanchoe fedtschenkoi genes (K_fedtschenkoi_M2_v1)
obarthii_eg_gene	Oryza barthii genes (O.barthii_v1)
vangularis_eg_gene	Vigna angularis genes (Vigan1.1)
mdgolden_eg_gene	Malus domestica Golden genes (ASM211411v1)
ccapsularis_eg_gene	Corchorus capsularis genes (CCACVL1_1.0)
omeridionalis_eg_gene	Oryza meridionalis genes (Oryza_meridionalis_v1.3)
csativus_eg_gene	Cucumis sativus genes (ASM407v2)
orufipogon_eg_gene	Oryza rufipogon genes (OR_W1943)
tastanley_eg_gene	Triticum aestivum Stanley genes (PGSBv2.2_Stanley)
cavellana_eg_gene	Corylus avellana genes (CavTom2PMs-1.0)
talancer_eg_gene	Triticum aestivum Lancer genes (PGSBv2.0_Lancer)
boleracea_eg_gene	Brassica oleracea genes (BOL)
olucimarinus_eg_gene	Ostreococcus lucimarinus genes (ASM9206v1)
atauschii_eg_gene	Aegilops tauschii genes (Aet v4.0)
osativa_eg_gene	Oryza sativa Japonica Group genes (IRGSP-1.0)
gsulphuraria_eg_gene	Galdieria sulphuraria genes (ASM34128v1)
athaliana_eg_gene	Arabidopsis thaliana genes (TAIR10)
dcarota_eg_gene	Daucus carota genes (ASM162521v1)
taweebil_eg_gene	Triticum aestivum Weebill genes (EI_WeebilV1)
vradiata_eg_gene	Vigna radiata genes (Vradiata_ver6)
alyrata_eg_gene	Arabidopsis lyrata genes (v.1.0)
taparagon_eg_gene	Triticum aestivum Paragon genes (EI_paragon)
atrichopoda_eg_gene	Amborella trichopoda genes (AMTR1.0)
olongistaminata_eg_gene	Oryza longistaminata genes (O_longistaminata_v1.0)
tajagger_eg_gene	Triticum aestivum Jagger genes (PGSBv2.0_Jagger)
bnapus_eg_gene	Brassica napus genes (AST_PRJEB5043_v1)
brapa_eg_gene	Brassica rapa genes (Brapa_1.0)
acomosus_eg_gene	Ananas comosus genes (F153)
obrachyantha_eg_gene	Oryza brachyantha genes (Oryza_brachyantha.v1.4b)
macuminata_eg_gene	Musa acuminata genes (Musa_acuminata_v2)
pdulcis_eg_gene	Prunus dulcis genes (ALMONDv2)
lperrieri_eg_gene	Leersia perrieri genes (Lperr_V1.4)
